Script started on 2020-04-16 00:59:45-04:00 [TERM="xterm-256color" TTY="/dev/pts/13" COLUMNS="80" LINES="24"]
rbey1@remote00:~/i240b/submit/lab8$ sleep 5\ echo 123 &[Ksleep 5\ echo 123 &[1@'[C[1@'
[1] 3651482
rbey1@remote00:~/i240b/submit/lab8$ sleep: invalid time interval ‘5\\’
sleep: invalid time interval ‘echo’
Try 'sleep --help' for more information.
z[K^C
[1]+  Exit 1                  sleep 5'\' echo 123
rbey1@remote00:~/i240b/submit/lab8$ sleep 5'\' echo 123 &[1P[1@/
[1] 3651954
rbey1@remote00:~/i240b/submit/lab8$ sleep: invalid time interval ‘5/’
sleep: invalid time interval ‘echo’
Try 'sleep --help' for more information.
^C
[1]+  Exit 1                  sleep 5'/' echo 123
rbey1@remote00:~/i240b/submit/lab8$ sleep 5'/' echo 123 &[C[1P[1P[1P[C[1@ [1@&[1@;
bash: syntax error near unexpected token `;'
rbey1@remote00:~/i240b/submit/lab8$ sleep 5 &; echo 123 &[1@'[C[1@'
[1] 3652126
[2] 3652127
rbey1@remote00:~/i240b/submit/lab8$ bash: ;: command not found
^C
[1]-  Done                    sleep 5
[2]+  Exit 127                ';' echo 123
rbey1@remote00:~/i240b/submit/lab8$ sleep 5 &';' echo 123 &[1@\[1P[1P[1P[1P[1P[1P
[1] 3652252
rbey1@remote00:~/i240b/submit/lab8$ sleep: invalid time interval ‘echo’
Try 'sleep --help' for more information.
^C
[1]+  Exit 1                  sleep 5 echo 123
rbey1@remote00:~/i240b/submit/lab8$ sleep 5 echo 123 &[1@&[1@&[1@ 
[1] 3652612
rbey1@remote00:~/i240b/submit/lab8$ gygv123

bash: gygv: command not found
[1]+  Done                    sleep 5 && echo 123
rbey1@remote00:~/i240b/submit/lab8$ gygvsleep 5 && echo 123 &
[1] 3652683
rbey1@remote00:~/i240b/submit/lab8$ 123
^C
[1]+  Done                    sleep 5 && echo 123
rbey1@remote00:~/i240b/submit/lab8$ sleep 5 && echo 123 &
[1] 3652770
rbey1@remote00:~/i240b/submit/lab8$ goo
bash: goo: command not found
rbey1@remote00:~/i240b/submit/lab8$ 123
^C
[1]+  Done                    sleep 5 && echo 123
rbey1@remote00:~/i240b/submit/lab8$ grep -i 'MAINQ[K9' [K[K[K)' [K[K[K(' `find ~/cs240/projev[Kcts -name  'nae[K[K[K[K[K[A[C[C[C[C[C[C[C[C[C[C[C[C[C[C[C[C[C[C[C[C[C[C[C[C[C[C[C[C[C[C[C[C[C[C[C[C[C[C[C[C[C[C[C[C[C[C[C[C[C[C[C[C[C[C[C[C[C[C[C[C[C[C[C[C[C[C[C[C[C[C[C[C[C[C[C[C[C[C[C[K
[K[A[C[C[C[C[C[C[C[C[C[C[C[C[C[C[C[C[C[C[C[C[C[C[C[C[C[C[C[C[C[C[C[C[C[C[C[C[C[C[C[C[C[C[C[C[C[C[C[C[C[C[C[C[C[C[C[C[C[C[C[C[C[C[C[C[C[C[C[C[C[C[C[C[C[C[C[C[C[C[Ce  '*.cc'`
/home/rbey1/cs240/projects/prj1-sol/wordcounts.cc:main(int argc, char *argv[])
/home/rbey1/cs240/projects/prj2/extras/seq-test.cc:int main(int argc, char *argv[]) {
/home/rbey1/cs240/projects/prj2-sol/nums.cc:int main(int argc, char* argv[])
/home/rbey1/cs240/projects/prj2-sol/seq-test.cc:int main(int argc, char *argv[]) {
rbey1@remote00:~/i240b/submit/lab8$ grep -i '[K[K[K[K[K[K[K[K[Kwc -l `find ~cs240[C[C[C[C/cs240[C[C[C[C[C/projects -name '*.cc'`
  159 /home/rbey1/cs240/projects/prj1-sol/wordcounts.cc
  123 /home/rbey1/cs240/projects/prj2/extras/command.cc
   72 /home/rbey1/cs240/projects/prj2/extras/seq-test.cc
  123 /home/rbey1/cs240/projects/prj2-sol/command.cc
   66 /home/rbey1/cs240/projects/prj2-sol/nums.cc
   72 /home/rbey1/cs240/projects/prj2-sol/seq-test.cc
  615 total
rbey1@remote00:~/i240b/submit/lab8$ exit

Script done on 2020-04-16 01:15:12-04:00 [COMMAND_EXIT_CODE="0"]
